# 自定義簡繁轉換對照表
# 格式：簡體 => 繁體
# 用於修正 OpenCC 預設轉換的特殊詞彙

# 台灣特有詞彙
软件 => 軟體
硬件 => 硬體
网络 => 網路
程序 => 程式
服务器 => 伺服器
数据库 => 資料庫
内存 => 記憶體
缓存 => 快取
默认 => 預設
视窗 => 視窗
文件夹 => 資料夾
鼠标 => 滑鼠
硬盘 => 硬碟
优盘 => 隨身碟
宽带 => 寬頻
带宽 => 頻寬
字节 => 位元組
信息 => 資訊
数字 => 數位
音频 => 音訊
视频 => 視訊
搜索 => 搜尋
在线 => 線上
离线 => 離線
邮政编码 => 郵遞區號
身份证 => 身分證
出租车 => 計程車
地铁 => 捷運
公交车 => 公車
自行车 => 腳踏車
摩托车 => 機車
土豆 => 馬鈴薯
西红柿 => 番茄
菠萝 => 鳳梨
酸奶 => 優格
奶酪 => 起司
